1111111111111
11111111100C1
1100000000011
1000000000001
1P111111E0001
1111111111111