11111111111111111
1C100C0000C010001
10100001000010011
1C100C0000C011E11
1010000100000A011
1C100C000AC0C0001
10100001000000001
1C100C0000C011011
10100001000010001
1P001101000001011
11111111111111111