1111111111111
1A01CCCCCCCC1
1000011111C01
1P0011E000001
1111111111111