1111111111111
1CCCCCC1CCCC1
1100000011111
1000000000001
1P111111E0001
1111111111111