11111111111111111111111111111
1E0000000000000C00000C0000001
11100101001000001010010000001
10100101001000001010010000001
10100101001000001010010000001
10100101001000001010010000001
101001010A1000001010010000001
10100101001010001010010000001
10100C01001000001010010000001
1011111000111A100010010000001
1P00000000C00A000000000000001
11111111111111111111111111111