1111111111111
11C1010011C11
10C1000000001
10C0000000001
1PC10000E0011
1111111111111