111111111
100000C01
10P000001
10C000E01
100A00A01
111111111