11111111111111111111111111
1P111111111111111111111E11
1000000000A0000000000000A1
11000100010001000010100011
1101110111A101011110101011
11000100010001010A10101011
1111010111001101101A101011
11000100010101000010100A11
10000000000000000000000011
1C111111111111111111111C11
11111111111111111111111111