11111111111
11110CE1111
11110001111
11110001111
11110001111
10000000001
1C0A0P0A001
10000000001
11110001111
11110001111
11C10001111
11111111111