111111111
100000C01
10P000101
10C001EA1
100000A01
111111111