1111111111111111111111111111111111
1E0000000000000C000A0C000000000001
10100101001000001010010A0000010101
1010A1001010101A001001000A0001010111111
1P00000A0C00C00000000000000A0000C1
1111111111111111111111111111111111